{
    "map": [[0, 1, 1, 1, 1, 1, 1, 1, 0, 0],
            [0, 0, 0, 1, 0, 1, 1, 1, 0, 1],
            [0, 1, 0, 1, 0, 1, 0, 1, 0, 0],
            [0, 1, 0, 0, 0, 1, 0, 1, 1, 0],
            [1, 1, 1, 0, 1, 1, 0, 1, 0, 0],
            [0, 0, 0, 0, 1, 1, 0, 1, 1, 0],
            [1, 1, 1, 0, 0, 1, 0, 1, 1, 0],
            [1, 1, 1, 1, 0, 1, 0, 0, 0, 0],
            [0, 0, 0, 0, 0, 0, 0, 1, 0, 1],
            [1, 1, 1, 1, 1, 1, 1, 1, 0, 1]
    ],
    "start_point": [9, 0],
    "end_point": [0, 0]
}